NO ./textures/images/gavi.xpm42
SO ./textures/images/south.xpm42
EA ./textures/images/east.xpm42
WE ./textures/images/west.xpm42
F 0,0,0
C 255,255,255

11111111111111111111111111111111111111111111111111111111111111111111111111111
10000000000000000000000000000000000000000000000000000000000000000000000000001
10000000000000000000000000000000000000000000000000000000000000000000000000001
10001111111111100000000000000000111111111110000000000000111111111111100000001
10001000000000100000000000000000100000000010000000000000100000000000100000001
10001000000000100000000000000000100000000010000000000000100000000000100000001
10001000000000100000000000000000100000000010000000000000100000000000100000001
10001000000000100000000000000000100000000010000000000000100000000000100000001
10001000000000111111110000000111100000000010000000000000100000000000100000001
10001000000000000000010000000100000000000010000000000000100000000000100000001
10001000000000000000010000000100000000000010000000000000100000000000100000001
10001000000000000000010000000100000000000010000000000000100000000000100000001
10001000000000000000010000000100000000000010000000000000100000000000100000001
10001111111111111111110000000100000000000010000000000000111111111111100000001
10000000000000000000000000000100000000000010000000000000000000000000000000001
1000000000000000000000000000010000000E000010000000000000000000000000000000001
10000000000000000000000000000100000000000010000000000000000000000000000000001
10000000000000000000000000000100000000000010000000000000000000000000000000001
10000000000000000000000000000100000000000010000000000000000000000000000000001
10000000000000000000000000000100000000000010000000000000000000000000000000001
10000000000000000000000000000100000000000010000000000000000000000000000000001
10000000000000000000000000000111111111111110000000000000000000000000000000001
10000000000000000000000000000000000000000000000000000000000000000000000000001
10000000000000000000000000000000000000000000000000000000000000000000000000001
10000000000000000000000000000000000000000000000000000000000000000000000000001
10000000000000000000000000000000000000000000000000000000000000000000000000001
10000000000000000000000000000000000000000000000000000000000000000000000000001
10000000000000000000000000000000000000000000000000000000000000000000000000001
10000000000000000000000000000000000000000000000000000000000000000000000000001
10000000000000000000000000000000000000000000000000000000000000000000000000001
10000000000000000000000000000000000000000000000000000000000000000000000000011
10000000000000000000000000000000000000000000000000000000000000000000000000001
10000000000000000000000000000000000000000000000000000000000000000000000000001
10000000000000000000000000000000000000000000000000000000000000000000000000001
10000000000000000000000000000000000000000000000000000000000000000000000000001
10000000000000000000000000000000000000000000000000000000000000000000000000001
10000000000000000000000000000000000000000000000000000000000000000000000000001
10000000000000000000000000000000000000000000000000000000000000000000000000001
10000000000000000000000000000000000000000000000000000000000000000000000000001
11111111111111111111111111111111111111111111111111111111111111111111111111111
