NO  ./textures/north.xpm
SO ./textures/south.xpm
EA ./textures/east.xpm
WE ./textures/west.xpm
F 139,69,19
C 70,130,180

1111111111111111111111111111111111111111111111111111111111111
1000000000000000000000000000000000000000000000000000000000001
1000000000000000000000000000000000000000000000000000000000001
1000111111111111100000000000011111111111111100000000000000001
1000100000000000100000000000010000000000000100000000000000001
1000100000000000100000000000010000000000000100000000000000001
1000100000000000100000000000010000000000000100000000000000001
1000100000000000100000000000010000000000000100000000000000001
1000100000000000100000000000010000000000000100000000000000001
1000100000000000100000000000010000000000000100000000000000001
1000100000000000100000000000010000000000000100000000000000001
1000100000000000100000000000010000000000000100000000000000001
1000100000000000100000000000010000000000000100000000000000001
1000100000000000100000000000010000000000000100000000000000001
1000100000000000100000000000010000000000000100000000000000001
1000100000000000111111111111110000000000000100000000000000001
1000100000000000000000000000000000000000000100000000000000001
1000100000000000000000000000000000000000000100000000000000001
1000100000000000000000000000000000000000000100000000000000001
1000100000000000000000001000000000000000000100000000000000001
1000100000000000000000N00000000000000000000100000000000000001
1000100000000000000000000000000000000000000100000000000000001
1000100000000000000000000000000000000000000100000000000000001
1000100000000000000000000000000000000000000100000000000000001
1000100000000000000000000000000000000000000100000000000000001
1000111111111111111111111111111111111111111100000000000000001
1000000000000000000000000000000000000000000000000000000000001
1000000000000000000000000000000000000000000000000000000000001
1000000000000000000000000000000000000000000000000000000000001
1111111111111111111111111111111111111111111111111111111111111
