NO  ./textures/north.xpm
SO ./textures/south.xpm
EA ./textures/east.xpm
WE ./textures/west.xpm
F 50,50,50
C 135,206,235

11111111111111111111111111111111111111111111111111
10000000000000000000000000000000000000000000000001
10000000000000000000000000000000000000000000000001
10000000000000000000000000000000000000000000000001
10000000000111111111111111111111111111111000000001
10000000000100000000000000000000000000001000000001
10000000000100000000000000000000000000001000000001
10000000000100000000000000000000000000001000000001NO  ./textures/north.xpm
SO ./textures/south.xpm
EA ./textures/east.xpm
WE ./textures/west.xpm
F 100,200,100
C 200,200,200

1111111
1000001
100N001
1000001
1111111

10000000000100000000000000000000000000001000000001
10000000000100000000000000000000000000001000000001
10000000000100000000000000000000000000001000000001
10000000000100000000000000000000000000001000000001
10000000000100000000000N00000000000000001000000001
10000000000100000000000000000000000000001000000001
10000000000100000000000000000000000000001000000001
10000000000100000000000000000000000000001000000001
10000000000100000000000000000000000000001000000001
10000000000100000000000000000000000000001000000001
10000000000100000000000000000000000000001000000001
10000000000111111111111111111111111111111000000001
10000000000000000000000000000000000000000000000001
10000000000000000000000000000000000000000000000001
10000000000000000000000000000000000000000000000001
10000000000000000000000000000000000000000000000001
11111111111111111111111111111111111111111111111111
